[
{
    "pw": 22, "ph": 16, "sx": 1, "sy": 13,
    "map": [
      1,1,1,1,1,1,1,1,1,1,1,1,1,1,1,1,1,1,1,1,1,1,
      1,0,0,0,0,0,0,0,0,0,0,0,0,0,0,0,0,0,0,0,0,1,
      1,0,0,0,0,0,0,0,0,0,0,0,0,0,0,0,0,0,0,0,0,1,
      1,0,0,1,1,1,0,0,0,0,0,0,0,1,1,1,0,0,0,0,0,1,
      1,0,0,0,0,0,0,0,0,0,0,0,0,0,0,0,0,0,0,0,0,1,
      1,0,0,0,0,0,0,1,1,1,0,0,1,1,1,0,0,0,0,0,0,1,
      1,0,0,0,0,0,0,0,0,0,0,0,0,0,0,0,0,0,0,0,0,1,
      1,0,0,0,0,0,0,0,0,0,0,0,0,0,0,0,0,0,0,0,0,1,
      1,0,0,0,0,0,0,1,1,1,0,0,1,1,1,0,0,0,0,0,0,1,
      1,0,0,0,0,0,0,0,0,0,0,0,0,0,0,0,0,0,0,0,0,1,
      1,0,0,1,1,1,1,1,1,0,0,0,1,1,1,1,1,1,0,0,0,0,1,
      1,0,0,0,0,0,0,0,0,0,0,0,0,0,0,0,0,0,0,0,0,1,
      1,0,0,0,0,0,0,0,0,0,0,0,0,0,0,0,0,0,0,0,8,1,
      1,1,1,1,1,1,1,1,1,1,1,1,1,1,1,1,1,1,1,1,1,1,
      1,1,1,1,1,1,1,1,1,1,1,1,1,1,1,1,1,1,1,1,1,1,
      1,1,1,1,1,1,1,1,1,1,1,1,1,1,1,1,1,1,1,1,1,1
    ],
    "triggers": [
      {"id": "sp4", "cx": 11, "cy": 13, "r": 1.5, "action": "spike_wall", "row": 13, "cols": [7,8,9,10,11,12,13,14]},
      {"id": "gv4", "cx": 11, "cy": 6, "r": 1.2, "action": "gravity_flip"},
      {"id": "d4", "cx": 4, "cy": 3, "r": 1.5, "action": "drop_block", "blockCol": 4, "blockRow": 1}
    ]
  },
  {
    "pw": 24, "ph": 16, "sx": 1, "sy": 13,
    "map": [
      1,1,1,1,1,1,1,1,1,1,1,1,1,1,1,1,1,1,1,1,1,1,1,1,
      1,0,0,0,0,0,0,0,0,0,0,0,0,0,0,0,0,0,0,0,0,0,0,1,
      1,0,0,0,0,0,0,0,0,0,4,0,0,0,0,0,0,4,0,0,0,0,0,1,
      1,0,0,1,1,1,1,1,0,0,0,0,0,0,0,1,1,1,1,1,0,0,1,
      1,0,0,0,0,0,0,0,0,0,0,0,0,0,0,0,0,0,0,0,0,0,1,
      1,0,0,0,0,0,0,0,0,0,0,0,0,0,0,0,0,0,0,0,0,0,1,
      1,0,0,0,0,0,0,0,0,0,0,0,0,0,0,0,0,0,0,0,0,0,1,
      1,0,0,0,0,0,0,1,1,1,1,0,0,1,1,1,1,0,0,0,0,0,0,1,
      1,0,0,0,0,0,0,0,0,0,0,0,0,0,0,0,0,0,0,0,0,0,0,1,
      1,0,0,0,0,0,0,0,0,0,0,0,0,0,0,0,0,0,0,0,0,0,0,1,
      1,0,0,0,0,0,0,0,0,0,0,0,0,0,0,0,0,0,0,0,0,0,1,
      1,0,0,1,1,1,1,1,1,0,0,0,1,1,1,1,1,1,0,0,0,0,8,1,
      1,1,1,1,1,1,1,1,1,1,1,1,1,1,1,1,1,1,1,1,1,1,1,1,
      1,1,1,1,1,1,1,1,1,1,1,1,1,1,1,1,1,1,1,1,1,1,1,1,
      1,1,1,1,1,1,1,1,1,1,1,1,1,1,1,1,1,1,1,1,1,1,1,1,
      1,1,1,1,1,1,1,1,1,1,1,1,1,1,1,1,1,1,1,1,1,1,1,1
    ],
    "triggers": [
      {"id": "d5", "cx": 10, "cy": 5, "r": 1.5, "action": "drop_block", "blockCol": 10, "blockRow": 1},
      {"id": "d6", "cx": 14, "cy": 5, "r": 1.5, "action": "drop_block", "blockCol": 14, "blockRow": 1},
      {"id": "gv5", "cx": 12, "cy": 9, "r": 1.2, "action": "gravity_flip"},
      {"id": "sp5", "cx": 12, "cy": 13, "r": 1.5, "action": "spike_wall", "row": 13, "cols": [3,4,5,6,7,8,9,10,11,12,13,14,15,16,17,18,19,20]}
    ]
  }
]