[
  {
    "pw": 20, "ph": 14, "sx": 1, "sy": 11,
    "map": [
      1,1,1,1,1,1,1,1,1,1,1,1,1,1,1,1,1,1,1,1,
      1,0,0,0,0,0,0,0,0,0,0,0,0,0,0,0,0,0,0,1,
      1,0,0,0,0,0,0,0,0,0,0,0,0,0,0,0,0,0,0,1,
      1,0,0,0,0,0,1,1,1,0,0,0,0,1,0,0,0,0,0,1,
      1,0,0,0,0,0,0,0,0,0,4,0,0,0,0,0,0,0,0,1,
      1,0,0,1,1,0,0,0,0,1,1,1,0,0,1,1,0,0,0,1,
      1,0,0,0,0,0,0,4,0,0,0,0,0,0,0,4,0,0,0,1,
      1,0,1,1,0,0,1,1,1,0,0,0,1,1,1,1,1,0,0,1,
      1,0,0,0,0,0,0,0,0,0,4,0,0,0,0,0,0,0,0,1,
      1,0,0,0,1,1,1,0,0,1,1,1,0,0,0,6,6,0,0,1,
      1,0,0,0,0,0,0,0,0,0,0,0,0,4,4,0,0,0,8,1,
      1,1,0,0,1,1,1,1,0,0,1,1,1,1,1,1,1,1,1,1,
      1,0,0,0,0,0,0,0,0,0,0,0,0,0,0,0,0,0,0,1,
      1,1,1,1,1,1,1,1,1,1,1,1,1,1,1,1,1,1,1,1
    ],
    "triggers": [
      {"id": "drop1", "cx": 7, "cy": 6, "r": 1.5, "action": "drop_block", "blockCol": 7, "blockRow": 1},
      {"id": "inv1",  "cx": 15, "cy": 6, "r": 1.2, "action": "gravity_flip"}
    ]
  },
  {
    "pw": 22, "ph": 14, "sx": 1, "sy": 11,
    "map": [
      1,1,1,1,1,1,1,1,1,1,1,1,1,1,1,1,1,1,1,1,1,1,
      1,0,0,0,0,0,0,0,0,0,0,0,0,0,0,0,0,0,0,0,0,1,
      1,0,0,0,0,0,0,0,0,0,0,0,0,0,0,5,5,5,0,0,0,1,
      1,0,0,1,1,1,0,0,0,0,0,0,0,0,0,0,0,0,0,4,0,1,
      1,0,0,0,0,0,0,4,0,0,0,0,0,0,1,1,1,1,1,1,1,1,
      1,0,0,0,0,0,1,1,1,0,0,0,0,0,0,0,0,0,0,0,0,1,
      1,0,4,0,0,0,0,0,0,0,0,0,0,0,0,0,0,0,0,0,0,1,
      1,1,1,1,0,0,0,0,0,6,6,6,0,0,0,0,5,0,0,0,0,1,
      1,0,0,0,0,0,0,0,0,0,0,0,0,0,0,0,0,0,4,0,0,1,
      1,0,0,0,1,1,1,1,0,0,0,0,1,1,1,1,1,0,0,0,0,1,
      1,0,0,0,0,0,0,0,0,7,0,0,0,0,0,0,0,0,0,0,8,1,
      1,1,0,1,1,1,1,1,0,1,0,0,1,1,1,1,1,1,1,1,1,1,
      1,0,0,0,0,0,0,0,0,0,0,0,0,0,0,0,0,0,0,0,0,1,
      1,1,1,1,1,1,1,1,1,1,1,1,1,1,1,1,1,1,1,1,1,1
    ],
    "triggers": [
      {"id": "sp1", "cx": 9, "cy": 10, "r": 1.5, "action": "spike_wall", "row": 10, "cols": [8,9,10,11]},
      {"id": "gv1", "cx": 9, "cy": 10, "r": 1.2, "action": "gravity_flip"}
    ]
  },
  {
    "pw": 24, "ph": 15, "sx": 1, "sy": 12,
    "map": [
      1,1,1,1,1,1,1,1,1,1,1,1,1,1,1,1,1,1,1,1,1,1,1,1,
      1,0,0,0,0,0,0,0,0,0,0,0,0,0,0,0,0,0,0,0,0,0,0,1,
      1,0,0,0,0,0,0,0,0,0,0,0,5,5,0,0,0,0,0,0,0,0,0,0,
      1,0,0,1,1,1,0,0,4,0,0,0,0,0,0,0,0,0,4,4,4,0,0,1,
      1,0,0,0,0,0,0,1,1,1,0,0,0,0,0,1,1,1,1,1,1,1,0,1,
      1,0,0,0,0,0,0,0,0,0,0,0,0,0,0,0,0,0,0,0,0,0,0,1,
      1,4,0,0,0,0,6,6,6,6,0,0,0,0,0,0,0,0,0,0,0,0,0,1,
      1,1,1,1,0,0,0,0,0,0,0,0,7,0,0,0,0,5,0,0,0,0,0,1,
      1,0,0,0,0,0,0,0,0,0,1,1,1,1,0,0,1,1,1,0,0,0,4,1,
      1,0,0,0,1,1,1,0,0,0,0,0,0,0,0,0,0,0,0,0,0,1,1,1,
      1,0,4,0,0,0,0,0,0,0,0,0,0,0,4,0,0,0,0,0,0,0,0,1,
      1,1,1,1,0,0,0,0,1,1,1,1,0,0,1,1,1,0,0,6,6,0,0,1,
      1,0,0,0,0,0,0,0,0,0,0,0,0,0,0,0,0,0,0,0,0,0,8,1,
      1,1,0,1,1,1,1,1,0,0,1,1,1,1,1,1,1,1,1,1,1,1,1,1,
      1,1,1,1,1,1,1,1,1,1,1,1,1,1,1,1,1,1,1,1,1,1,1,1
    ],
    "triggers": [
      {"id": "d1", "cx": 12, "cy": 7, "r": 1.5, "action": "drop_block", "blockCol": 12, "blockRow": 1},
      {"id": "d2", "cx": 22, "cy": 8, "r": 1.5, "action": "drop_block", "blockCol": 22, "blockRow": 1}
    ]
  },
  {
    "pw": 20, "ph": 16, "sx": 1, "sy": 13,
    "map": [
      1,1,1,1,1,1,1,1,1,1,1,1,1,1,1,1,1,1,1,1,
      1,0,0,0,0,0,0,0,0,0,0,0,0,0,0,0,0,0,0,1,
      1,0,1,1,1,1,1,0,0,0,0,0,1,1,1,1,1,0,0,1,
      1,0,0,0,0,0,0,0,0,0,0,0,0,0,0,0,0,0,0,1,
      1,0,0,0,0,0,0,0,0,0,0,0,0,0,0,0,0,0,0,1,
      1,1,1,0,0,0,0,0,0,0,0,0,0,0,0,0,0,1,1,1,
      1,0,0,0,0,0,0,0,0,0,0,0,0,0,0,0,0,0,0,1,
      1,0,0,0,0,0,0,0,0,0,0,0,0,0,0,0,0,0,0,1,
      1,0,0,0,1,1,1,1,0,0,0,0,1,1,1,1,0,0,0,1,
      1,0,0,0,0,0,0,0,0,0,0,0,0,0,0,0,0,0,0,1,
      1,0,0,0,0,0,0,0,0,0,0,0,0,0,0,0,0,0,0,1,
      1,0,0,0,0,0,0,0,0,0,0,0,0,0,0,0,0,0,0,1,
      1,0,0,0,0,0,0,0,0,0,0,0,0,0,0,0,0,0,0,1,
      1,0,0,0,0,0,0,0,0,0,0,0,0,0,0,0,0,0,0,0,1,
      1,1,1,1,1,1,1,1,1,1,1,1,1,1,1,1,1,1,1,1,
      1,1,1,1,1,1,1,1,1,1,1,1,1,1,1,1,1,1,1,1
    ],
    "triggers": [
      {"id": "inv2", "cx": 10, "cy": 8, "r": 1.2, "action": "gravity_flip"}
    ]
  },
  {
    "pw": 24, "ph": 14, "sx": 1, "sy": 10,
    "map": [
      1,1,1,1,1,1,1,1,1,1,1,1,1,1,1,1,1,1,1,1,1,1,1,1,
      1,0,0,0,0,0,0,0,0,0,0,0,0,0,0,0,0,0,0,0,0,0,0,1,
      1,0,0,0,0,0,0,0,0,0,4,0,0,0,0,0,0,0,0,0,0,0,0,1,
      1,0,0,1,1,1,1,1,1,1,1,1,1,1,1,1,1,1,1,1,1,0,0,1,
      1,0,0,0,0,0,0,0,0,0,0,0,0,0,0,0,0,0,0,0,0,0,0,1,
      1,0,0,0,0,0,0,0,0,0,0,0,0,0,0,0,0,0,0,0,0,0,0,1,
      1,0,0,0,0,0,0,0,0,0,0,0,0,0,0,0,0,0,0,0,0,0,0,1,
      1,0,0,0,0,0,0,0,0,0,0,0,0,0,0,0,0,0,0,0,0,0,1,
      1,0,0,0,0,0,0,0,0,0,0,0,0,0,0,0,0,0,0,0,0,0,1,
      1,1,1,1,1,1,1,1,1,1,1,1,1,1,1,1,1,1,1,1,1,1,1,1,
      1,0,0,0,0,0,0,0,0,0,0,0,0,0,0,0,0,0,0,0,0,0,0,1,
      1,0,0,0,0,0,0,0,0,0,0,0,0,0,0,0,0,0,0,0,0,0,1,
      1,0,0,0,0,0,0,0,0,0,0,0,0,0,0,0,0,0,0,0,0,0,8,1,
      1,1,1,1,1,1,1,1,1,1,1,1,1,1,1,1,1,1,1,1,1,1,1,1
    ],
    "triggers": [
      {"id": "inv3", "cx": 12, "cy": 5, "r": 1.5, "action": "gravity_flip"}
    ]
  },
  {
    "pw": 22, "ph": 13, "sx": 1, "sy": 10,
    "map": [
      1,1,1,1,1,1,1,1,1,1,1,1,1,1,1,1,1,1,1,1,1,1,
      1,0,0,0,0,0,0,1,1,1,1,0,0,0,0,0,0,0,0,0,0,1,
      1,0,0,0,0,0,0,0,0,0,0,0,0,0,0,0,0,0,0,0,0,1,
      1,0,0,1,1,1,0,0,0,0,0,0,1,1,1,0,0,0,0,0,1,
      1,0,0,0,0,0,0,0,0,0,0,0,0,0,0,0,0,0,0,0,0,1,
      1,0,0,0,0,0,0,0,0,0,0,0,0,0,0,0,0,0,0,0,0,1,
      1,0,0,0,0,0,0,0,0,0,0,0,0,0,0,0,0,0,0,0,0,1,
      1,0,0,0,0,0,0,0,0,0,0,0,0,0,0,0,0,4,4,4,0,1,
      1,0,0,0,0,0,0,0,0,0,0,0,0,0,0,0,1,1,1,1,1,1,
      1,0,0,0,0,0,0,0,0,0,0,0,0,0,0,0,0,0,0,0,0,1,
      1,1,1,1,1,1,1,1,1,1,1,1,1,1,1,1,1,1,1,1,1,1,
      1,1,1,1,1,1,1,1,1,1,1,1,1,1,1,1,1,1,1,1,1,1
    ],
    "triggers": [
      {"id": "d3", "cx": 8,  "cy": 4, "r": 1.3, "action": "drop_block", "blockCol": 8,  "blockRow": 1},
      {"id": "d4", "cx": 16, "cy": 4, "r": 1.3, "action": "drop_block", "blockCol": 16, "blockRow": 1}
    ]
  },
  {
    "pw": 18, "ph": 18, "sx": 1, "sy": 15,
    "map": [
      1,1,1,1,1,1,1,1,1,1,1,1,1,1,1,1,1,1,
      1,0,0,0,0,0,0,0,0,0,0,0,0,0,0,0,0,1,
      1,0,1,1,1,1,1,0,0,0,0,0,1,1,1,1,0,1,
      1,0,0,0,0,0,0,0,0,0,0,0,0,0,0,0,0,1,
      1,0,0,0,0,0,0,0,0,0,0,0,0,0,0,0,0,1,
      1,1,1,1,0,0,0,0,0,0,0,0,0,0,1,1,1,1,
      1,0,0,0,0,0,0,0,0,0,0,0,0,0,0,0,0,1,
      1,0,0,0,0,0,0,0,0,0,0,0,0,0,0,0,0,1,
      1,0,0,0,0,0,0,0,4,4,4,0,0,0,0,0,0,1,
      1,0,0,0,0,0,0,1,1,1,1,1,0,0,0,0,0,1,
      1,0,0,0,0,0,0,0,0,0,0,0,0,0,0,0,0,1,
      1,0,0,0,0,0,0,0,0,0,0,0,0,0,0,0,0,1,
      1,0,0,0,0,0,0,0,0,0,0,0,0,0,0,0,0,1,
      1,0,1,1,1,1,1,0,0,0,0,0,1,1,1,1,0,1,
      1,0,0,0,0,0,0,0,0,0,0,0,0,0,0,0,0,1,
      1,1,1,1,1,1,1,1,1,1,1,1,1,1,1,1,1,1,
      1,1,1,1,1,1,1,1,1,1,1,1,1,1,1,1,1,1,
      1,1,1,1,1,1,1,1,1,1,1,1,1,1,1,1,1,1
    ],
    "triggers": []
  },
  {
    "pw": 20, "ph": 12, "sx": 1, "sy": 9,
    "map": [
      1,1,1,1,1,1,1,1,1,1,1,1,1,1,1,1,1,1,1,1,
      1,0,0,0,0,0,0,0,0,0,0,0,0,0,0,0,0,0,0,1,
      1,0,0,0,0,0,0,0,0,0,0,0,0,0,0,0,0,0,0,1,
      1,0,0,0,0,0,0,0,0,0,0,0,0,0,0,0,0,0,0,1,
      1,0,0,0,0,0,0,0,0,0,0,0,0,0,0,0,0,0,0,1,
      1,0,0,0,0,0,0,0,0,0,0,0,0,0,0,0,0,0,0,1,
      1,0,0,0,0,4,4,0,0,0,0,0,0,0,0,0,0,0,0,1,
      1,0,0,0,0,0,0,0,0,0,0,0,0,0,0,0,0,0,0,1,
      1,0,0,0,0,0,0,0,0,0,0,0,0,0,0,0,0,0,0,1,
      1,1,1,1,1,1,1,1,1,1,1,1,1,1,1,1,1,1,1,1,
      1,1,1,1,1,1,1,1,1,1,1,1,1,1,1,1,1,1,1,1,
      1,1,1,1,1,1,1,1,1,1,1,1,1,1,1,1,1,1,1,1
    ],
    "triggers": [
      {"id": "inv4", "cx": 10, "cy": 5, "r": 1.2, "action": "gravity_flip"}
    ]
  },
  {
    "pw": 26, "ph": 14, "sx": 1, "sy": 11,
    "map": [
      1,1,1,1,1,1,1,1,1,1,1,1,1,1,1,1,1,1,1,1,1,1,1,1,1,1,
      1,0,0,0,0,0,0,0,0,0,0,0,0,0,0,0,0,0,0,0,0,0,0,0,0,1,
      1,0,7,0,0,0,0,0,0,0,0,0,0,0,0,0,0,0,0,0,0,0,7,0,0,1,
      1,1,1,1,1,1,0,0,0,0,0,0,0,0,0,0,0,0,0,0,1,1,1,1,1,1,
      1,0,0,0,0,0,0,0,0,0,0,0,0,0,0,0,0,0,0,0,0,0,0,0,0,1,
      1,0,0,0,0,0,0,0,0,0,0,0,0,0,0,0,0,0,0,0,0,0,0,0,0,1,
      1,0,0,0,0,0,0,0,0,0,0,0,0,0,0,0,0,0,0,0,0,0,0,0,0,1,
      1,0,0,0,0,0,0,0,0,0,0,0,0,0,0,0,0,0,0,0,0,0,0,0,0,1,
      1,0,0,0,0,0,0,4,4,4,4,4,4,0,0,0,0,0,0,0,0,0,0,0,0,1,
      1,0,0,0,0,0,1,1,1,1,1,1,1,1,0,0,0,0,0,0,0,0,0,0,1,
      1,0,0,0,0,0,0,0,0,0,0,0,0,0,0,0,0,0,0,0,0,0,0,0,0,1,
      1,0,0,0,0,0,0,0,0,0,0,0,0,0,0,0,0,0,0,0,0,0,0,0,8,1,
      1,1,1,1,1,1,1,1,1,1,1,1,1,1,1,1,1,1,1,1,1,1,1,1,1,1,
      1,1,1,1,1,1,1,1,1,1,1,1,1,1,1,1,1,1,1,1,1,1,1,1,1,1
    ],
    "triggers": [
      {"id": "sp5", "cx": 13, "cy": 8, "r": 1.5, "action": "reveal_spikes"}
    ]
  },
  {
    "pw": 28, "ph": 15, "sx": 1, "sy": 12,
    "map": [
      1,1,1,1,1,1,1,1,1,1,1,1,1,1,1,1,1,1,1,1,1,1,1,1,1,1,1,1,
      1,0,0,0,0,0,0,0,0,0,0,0,0,0,0,0,0,0,0,0,0,0,0,0,0,0,0,1,
      1,0,0,0,0,0,0,0,0,0,0,0,0,0,0,0,0,0,0,0,0,0,0,0,0,0,0,1,
      1,0,0,1,1,1,1,1,1,1,1,1,1,1,1,1,1,1,1,1,1,1,1,0,0,0,0,1,
      1,0,0,0,0,0,0,0,0,0,0,0,0,0,0,0,0,0,0,0,0,0,0,0,0,0,0,1,
      1,0,0,0,0,0,0,0,0,0,0,0,0,0,0,0,0,0,0,0,0,0,0,0,0,0,0,1,
      1,0,0,0,0,0,0,0,0,0,0,0,0,0,0,0,0,0,0,0,0,0,0,0,0,0,0,1,
      1,0,0,0,0,0,0,0,0,0,0,0,0,0,0,0,0,0,0,0,0,0,0,0,0,0,0,1,
      1,0,0,0,0,0,0,0,0,0,0,0,0,0,0,0,0,0,0,0,0,0,0,0,0,0,0,1,
      1,0,0,0,0,0,0,0,0,0,0,0,0,0,0,0,0,0,0,0,0,0,0,0,0,0,0,1,
      1,0,0,0,0,0,0,0,0,0,0,0,0,0,0,0,0,0,0,0,0,0,0,0,0,0,0,1,
      1,0,0,0,0,0,0,0,0,0,0,0,0,0,4,4,4,4,0,0,0,0,0,0,0,0,1,
      1,1,1,1,1,1,1,1,1,1,1,1,1,1,1,1,1,1,1,1,1,1,1,1,1,1,1,1,
      1,1,1,1,1,1,1,1,1,1,1,1,1,1,1,1,1,1,1,1,1,1,1,1,1,1,1,1,
      1,1,1,1,1,1,1,1,1,1,1,1,1,1,1,1,1,1,1,1,1,1,1,1,1,1,1,1
    ],
    "triggers": [
      {"id": "inv6",  "cx": 14, "cy": 7, "r": 1.5, "action": "gravity_flip"},
      {"id": "drop5", "cx": 14, "cy": 3,  "r": 1.0, "action": "drop_block", "blockCol": 14, "blockRow": 1}
    ]
  }
]