[
  {
    "pw": 20, "ph": 14, "sx": 1, "sy": 11,
    "map": [
      1,1,1,1,1,1,1,1,1,1,1,1,1,1,1,1,1,1,1,1,
      1,0,0,0,0,0,0,0,0,0,0,0,0,0,0,0,0,0,0,1,
      1,0,0,0,0,0,0,0,0,0,0,0,0,0,0,0,0,0,0,1,
      1,0,0,0,0,0,1,1,1,0,0,0,0,1,0,0,0,0,0,1,
      1,0,0,0,0,0,0,0,0,0,4,0,0,0,0,0,0,0,0,1,
      1,0,0,1,1,0,0,0,0,1,1,1,0,0,1,1,0,0,0,1,
      1,0,0,0,0,0,0,4,0,0,0,0,0,0,0,4,0,0,0,1,
      1,0,1,1,0,0,1,1,1,0,0,0,1,1,1,1,1,0,0,1,
      1,0,0,0,0,0,0,0,0,0,4,0,0,0,0,0,0,0,0,1,
      1,0,0,0,1,1,1,0,0,1,1,1,0,0,0,6,6,0,0,1,
      1,0,0,0,0,0,0,0,0,0,0,0,0,4,4,0,0,0,8,1,
      1,1,0,0,1,1,1,1,0,0,1,1,1,1,1,1,1,1,1,1,
      1,0,0,0,0,0,0,0,0,0,0,0,0,0,0,0,0,0,0,1,
      1,1,1,1,1,1,1,1,1,1,1,1,1,1,1,1,1,1,1,1
    ],
    "triggers": [
      {"id": "drop1", "cx": 7, "cy": 6, "r": 1.5, "action": "drop_block", "blockCol": 7, "blockRow": 1},
      {"id": "inv1",  "cx": 15, "cy": 6, "r": 1.2, "action": "gravity_flip"}
    ]
  },
  {
    "pw": 22, "ph": 14, "sx": 1, "sy": 11,
    "map": [
      1,1,1,1,1,1,1,1,1,1,1,1,1,1,1,1,1,1,1,1,1,1,
      1,0,0,0,0,0,0,0,0,0,0,0,0,0,0,0,0,0,0,0,0,1,
      1,0,0,0,0,0,0,0,0,0,0,0,0,0,0,5,5,5,0,0,0,1,
      1,0,0,1,1,1,0,0,0,0,0,0,0,0,0,0,0,0,0,4,0,1,
      1,0,0,0,0,0,0,4,0,0,0,0,0,0,1,1,1,1,1,1,1,1,
      1,0,0,0,0,0,1,1,1,0,0,0,0,0,0,0,0,0,0,0,0,1,
      1,0,4,0,0,0,0,0,0,0,0,0,0,0,0,0,0,0,0,0,0,1,
      1,1,1,1,0,0,0,0,0,6,6,6,0,0,0,0,5,0,0,0,0,1,
      1,0,0,0,0,0,0,0,0,0,0,0,0,0,0,0,0,0,4,0,0,1,
      1,0,0,0,1,1,1,1,0,0,0,0,1,1,1,1,1,0,0,0,0,1,
      1,0,0,0,0,0,0,0,0,7,0,0,0,0,0,0,0,0,0,0,8,1,
      1,1,0,1,1,1,1,1,0,1,0,0,1,1,1,1,1,1,1,1,1,1,
      1,0,0,0,0,0,0,0,0,0,0,0,0,0,0,0,0,0,0,0,0,1,
      1,1,1,1,1,1,1,1,1,1,1,1,1,1,1,1,1,1,1,1,1,1
    ],
    "triggers": [
      {"id": "sp1", "cx": 9, "cy": 10, "r": 1.5, "action": "spike_wall", "row": 10, "cols": [8,9,10,11]},
      {"id": "gv1", "cx": 9, "cy": 10, "r": 1.2, "action": "gravity_flip"}
    ]
  },
  {
    "pw": 24, "ph": 15, "sx": 1, "sy": 12,
    "map": [
      1,1,1,1,1,1,1,1,1,1,1,1,1,1,1,1,1,1,1,1,1,1,1,1,
      1,0,0,0,0,0,0,0,0,0,0,0,0,0,0,0,0,0,0,0,0,0,0,1,
      1,0,0,0,0,0,0,0,0,0,0,0,5,5,0,0,0,0,0,0,0,0,0,0,
      1,0,0,1,1,1,0,0,4,0,0,0,0,0,0,0,0,0,4,4,4,0,0,1,
      1,0,0,0,0,0,0,1,1,1,0,0,0,0,0,1,1,1,1,1,1,1,0,1,
      1,0,0,0,0,0,0,0,0,0,0,0,0,0,0,0,0,0,0,0,0,0,0,1,
      1,4,0,0,0,0,6,6,6,6,0,0,0,0,0,0,0,0,0,0,0,0,0,1,
      1,1,1,1,0,0,0,0,0,0,0,0,7,0,0,0,0,5,0,0,0,0,0,1,
      1,0,0,0,0,0,0,0,0,0,1,1,1,1,0,0,1,1,1,0,0,0,4,1,
      1,0,0,0,1,1,1,0,0,0,0,0,0,0,0,0,0,0,0,0,0,1,1,1,
      1,0,4,0,0,0,0,0,0,0,0,0,0,0,4,0,0,0,0,0,0,0,0,1,
      1,1,1,1,0,0,0,0,1,1,1,1,0,0,1,1,1,0,0,6,6,0,0,1,
      1,0,0,0,0,0,0,0,0,0,0,0,0,0,0,0,0,0,0,0,0,0,8,1,
      1,1,0,1,1,1,1,1,0,0,1,1,1,1,1,1,1,1,1,1,1,1,1,1,
      1,1,1,1,1,1,1,1,1,1,1,1,1,1,1,1,1,1,1,1,1,1,1,1
    ],
    "triggers": [
      {"id": "d1", "cx": 12, "cy": 7, "r": 1.5, "action": "drop_block", "blockCol": 12, "blockRow": 1},
      {"id": "d2", "cx": 22, "cy": 8, "r": 1.5, "action": "drop_block", "blockCol": 22, "blockRow": 1}
    ]
  },
{
    "pw": 20, "ph": 14, "sx": 1, "sy": 11,
    "map": [
      1,1,1,1,1,1,1,1,1,1,1,1,1,1,1,1,1,1,1,1,
      1,0,0,0,0,0,0,0,0,0,0,0,0,0,0,0,0,0,0,1,
      1,0,0,4,4,0,0,0,0,0,0,0,4,4,0,0,0,0,0,1,
      1,0,0,1,1,1,0,0,0,0,0,1,1,1,1,0,0,0,0,1,
      1,0,0,0,0,0,0,0,0,0,0,0,0,0,0,0,0,0,0,1,
      1,0,0,0,0,0,0,1,1,1,0,0,0,0,0,0,1,1,0,1,
      1,0,0,0,0,0,0,0,0,0,0,0,0,0,0,0,0,0,0,1,
      1,0,0,0,0,0,0,0,0,0,0,0,0,0,0,0,0,0,0,1,
      1,0,0,0,0,0,0,4,0,0,0,0,4,0,0,0,0,0,0,1,
      1,0,0,1,1,1,1,1,1,0,0,1,1,1,1,1,1,0,0,1,
      1,0,0,0,0,0,0,0,0,0,0,0,0,0,0,0,0,0,8,1,
      1,1,1,1,1,1,1,1,1,1,1,1,1,1,1,1,1,1,1,1,
      1,1,1,1,1,1,1,1,1,1,1,1,1,1,1,1,1,1,1,1
    ],
    "triggers": [
      {"id": "gv4", "cx": 10, "cy": 7, "r": 1.2, "action": "gravity_flip"}
    ]
  },
  {
    "pw": 24, "ph": 14, "sx": 1, "sy": 11,
    "map": [
      1,1,1,1,1,1,1,1,1,1,1,1,1,1,1,1,1,1,1,1,1,1,1,1,
      1,0,0,0,0,0,0,0,0,0,0,0,0,0,0,0,0,0,0,0,0,0,0,1,
      1,0,0,0,0,0,0,0,0,0,4,0,0,0,0,0,4,0,0,0,0,0,0,1,
      1,0,0,1,1,1,1,1,0,0,0,0,0,0,0,1,1,1,1,1,0,0,0,1,
      1,0,0,0,0,0,0,0,0,0,0,0,0,0,0,0,0,0,0,0,0,0,0,1,
      1,0,0,0,0,0,0,0,0,0,0,0,0,0,0,0,0,0,0,0,0,0,0,1,
      1,0,0,0,0,0,0,4,0,0,0,0,0,0,0,0,4,0,0,0,0,0,0,1,
      1,0,1,1,1,1,1,1,1,0,0,0,0,1,1,1,1,1,1,1,0,0,0,1,
      1,0,0,0,0,0,0,0,0,0,0,0,0,0,0,0,0,0,0,0,0,0,0,1,
      1,0,0,0,0,0,0,0,0,0,0,0,0,0,0,0,0,0,0,0,0,0,0,1,
      1,0,0,0,0,0,0,1,1,1,1,0,0,1,1,1,1,0,0,0,0,0,8,1,
      1,1,1,1,1,1,1,1,1,1,1,1,1,1,1,1,1,1,1,1,1,1,1,1,
      1,1,1,1,1,1,1,1,1,1,1,1,1,1,1,1,1,1,1,1,1,1,1,1
    ],
    "triggers": [
      {"id": "d5", "cx": 10, "cy": 5, "r": 1.5, "action": "drop_block", "blockCol": 10, "blockRow": 1},
      {"id": "d6", "cx": 13, "cy": 5, "r": 1.5, "action": "drop_block", "blockCol": 13, "blockRow": 1},
      {"id": "gv5", "cx": 12, "cy": 10, "r": 1.2, "action": "gravity_flip"}
    ]
  },
  {
    "pw": 22, "ph": 16, "sx": 1, "sy": 13,
    "map": [
      1,1,1,1,1,1,1,1,1,1,1,1,1,1,1,1,1,1,1,1,1,1,
      1,0,0,0,0,0,0,0,0,0,0,0,0,0,0,0,0,0,0,0,0,1,
      1,0,0,0,0,0,0,0,0,0,0,0,0,0,0,0,0,0,0,0,0,1,
      1,0,0,1,1,1,1,1,0,0,0,0,1,1,1,1,1,0,0,0,0,1,
      1,0,0,0,0,0,0,0,0,0,0,0,0,0,0,0,0,0,0,0,0,1,
      1,0,0,0,0,0,0,0,0,0,0,0,0,0,0,0,0,0,0,0,0,1,
      1,0,0,0,0,0,4,4,4,0,0,0,0,4,4,4,0,0,0,0,0,1,
      1,0,1,1,1,1,1,1,1,1,0,0,1,1,1,1,1,1,1,0,0,1,
      1,0,0,0,0,0,0,0,0,0,0,0,0,0,0,0,0,0,0,0,0,1,
      1,0,0,0,0,0,0,0,0,0,0,0,0,0,0,0,0,0,0,0,0,1,
      1,0,0,0,0,0,0,0,0,0,0,0,0,0,0,0,0,0,0,0,0,1,
      1,0,0,0,0,0,0,0,0,0,0,0,0,0,0,0,0,0,0,0,0,1,
      1,0,0,1,1,1,1,1,0,0,0,0,1,1,1,1,1,0,0,0,8,1,
      1,1,1,1,1,1,1,1,1,1,1,1,1,1,1,1,1,1,1,1,1,1,1,1,
      1,1,1,1,1,1,1,1,1,1,1,1,1,1,1,1,1,1,1,1,1,1,1,1
    ],
    "triggers": [
      {"id": "sp6", "cx": 11, "cy": 10, "r": 1.5, "action": "spike_wall", "row": 10, "cols": [9,10,11,12]},
      {"id": "gv6", "cx": 11, "cy": 7, "r": 1.2, "action": "gravity_flip"}
    ]
  },
  {
    "pw": 24, "ph": 16, "sx": 1, "sy": 13,
    "map": [
      1,1,1,1,1,1,1,1,1,1,1,1,1,1,1,1,1,1,1,1,1,1,1,1,
      1,0,0,0,0,0,0,0,0,0,0,0,0,0,0,0,0,0,0,0,0,0,0,1,
      1,0,0,4,0,0,0,0,0,0,0,0,0,0,0,0,0,4,0,0,0,0,0,1,
      1,0,0,1,1,1,0,0,0,0,0,0,0,0,0,1,1,1,1,0,0,0,1,
      1,0,0,0,0,0,0,0,0,0,0,0,0,0,0,0,0,0,0,0,0,0,1,
      1,0,0,0,0,0,0,0,0,0,0,0,0,0,0,0,0,0,0,0,0,0,1,
      1,0,0,0,0,0,0,4,4,4,0,0,0,4,4,4,0,0,0,0,0,0,1,
      1,0,0,0,0,0,1,1,1,1,1,1,1,1,1,1,1,0,0,0,0,0,1,
      1,0,0,0,0,0,0,0,0,0,0,0,0,0,0,0,0,0,0,0,0,0,1,
      1,0,0,0,0,0,0,0,0,0,0,0,0,0,0,0,0,0,0,0,0,0,1,
      1,0,0,0,0,0,0,4,0,0,0,0,0,0,4,0,0,0,0,0,0,0,1,
      1,0,0,1,1,1,1,1,1,0,0,0,1,1,1,1,1,1,0,0,0,8,1,
      1,1,1,1,1,1,1,1,1,1,1,1,1,1,1,1,1,1,1,1,1,1,1,1,
      1,1,1,1,1,1,1,1,1,1,1,1,1,1,1,1,1,1,1,1,1,1,1,1,
      1,1,1,1,1,1,1,1,1,1,1,1,1,1,1,1,1,1,1,1,1,1,1,1
    ],
    "triggers": [
      {"id": "d7", "cx": 3, "cy": 3, "r": 1.5, "action": "drop_block", "blockCol": 3, "blockRow": 1},
      {"id": "d8", "cx": 20, "cy": 3, "r": 1.5, "action": "drop_block", "blockCol": 20, "blockRow": 1},
      {"id": "gv7", "cx": 12, "cy": 9, "r": 1.2, "action": "gravity_flip"}
    ]
  },
  {
    "pw": 26, "ph": 16, "sx": 1, "sy": 13,
    "map": [
      1,1,1,1,1,1,1,1,1,1,1,1,1,1,1,1,1,1,1,1,1,1,1,1,1,1,
      1,0,0,0,0,0,0,0,0,0,0,0,0,0,0,0,0,0,0,0,0,0,0,0,0,1,
      1,0,0,0,0,0,0,0,0,0,0,0,0,0,0,0,0,0,0,0,0,0,0,0,0,1,
      1,0,0,1,1,1,1,1,1,1,0,0,0,1,1,1,1,1,1,1,0,0,0,0,0,1,
      1,0,0,0,0,0,0,0,0,0,0,0,0,0,0,0,0,0,0,0,0,0,0,0,0,1,
      1,0,0,0,0,0,0,0,0,0,0,0,0,0,0,0,0,0,0,0,0,0,0,0,0,1,
      1,0,0,0,0,0,0,0,0,0,0,0,0,0,0,0,0,0,0,0,0,0,0,0,0,1,
      1,0,0,0,0,0,0,0,0,0,0,0,0,0,0,0,0,0,0,0,0,0,0,0,0,1,
      1,0,0,0,0,0,0,0,0,0,0,0,0,0,0,0,0,0,0,0,0,0,0,0,0,1,
      1,0,0,0,0,0,0,0,4,4,4,4,4,0,0,0,0,0,0,0,0,0,0,0,0,1,
      1,0,0,1,1,1,1,1,1,1,1,1,1,1,0,0,1,1,1,1,1,1,1,0,0,1,
      1,0,0,0,0,0,0,0,0,0,0,0,0,0,0,0,0,0,0,0,0,0,0,0,0,1,
      1,0,0,0,0,0,0,0,0,0,0,0,0,0,0,0,0,0,0,0,0,0,0,0,8,1,
      1,1,1,1,1,1,1,1,1,1,1,1,1,1,1,1,1,1,1,1,1,1,1,1,1,1,
      1,1,1,1,1,1,1,1,1,1,1,1,1,1,1,1,1,1,1,1,1,1,1,1,1,1,
      1,1,1,1,1,1,1,1,1,1,1,1,1,1,1,1,1,1,1,1,1,1,1,1,1,1
    ],
    "triggers": [
      {"id": "sp7", "cx": 10, "cy": 12, "r": 1.5, "action": "spike_wall", "row": 12, "cols": [8,9,10,11,12,13]},
      {"id": "gv8", "cx": 10, "cy": 6, "r": 1.2, "action": "gravity_flip"},
      {"id": "d9", "cx": 13, "cy": 4, "r": 1.5, "action": "drop_block", "blockCol": 13, "blockRow": 1}
    ]
  },
  {
    "pw": 28, "ph": 16, "sx": 1, "sy": 13,
    "map": [
      1,1,1,1,1,1,1,1,1,1,1,1,1,1,1,1,1,1,1,1,1,1,1,1,1,1,1,1,
      1,0,0,0,0,0,0,0,0,0,0,0,0,0,0,0,0,0,0,0,0,0,0,0,0,0,0,1,
      1,0,0,0,0,0,0,0,0,0,0,0,0,0,0,0,0,0,0,0,0,0,0,0,0,0,0,1,
      1,0,0,1,1,1,1,1,1,1,1,1,1,1,1,1,1,1,1,1,1,1,1,1,0,0,0,0,1,
      1,0,0,0,0,0,0,0,0,0,0,0,0,0,0,0,0,0,0,0,0,0,0,0,0,0,0,1,
      1,0,0,0,0,0,0,0,0,0,0,0,0,0,0,0,0,0,0,0,0,0,0,0,0,0,0,1,
      1,0,0,0,0,0,0,0,0,0,0,0,0,0,0,0,0,0,0,0,0,0,0,0,0,0,0,1,
      1,0,0,0,0,0,0,0,0,0,0,0,0,0,0,0,0,0,0,0,0,0,0,0,0,0,0,1,
      1,0,0,0,0,0,0,0,0,0,0,0,0,0,0,0,0,0,0,0,0,0,0,0,0,0,0,1,
      1,0,0,0,0,0,0,0,4,4,4,0,0,0,0,4,4,4,0,0,0,0,0,0,0,0,0,1,
      1,0,0,1,1,1,1,1,1,1,1,1,0,0,1,1,1,1,1,1,1,1,0,0,0,0,0,1,
      1,0,0,0,0,0,0,0,0,0,0,0,0,0,0,0,0,0,0,0,0,0,0,0,0,0,0,1,
      1,0,0,0,0,0,0,0,0,0,0,0,0,0,0,0,0,0,0,0,0,0,0,0,0,0,8,1,
      1,1,1,1,1,1,1,1,1,1,1,1,1,1,1,1,1,1,1,1,1,1,1,1,1,1,1,1,
      1,1,1,1,1,1,1,1,1,1,1,1,1,1,1,1,1,1,1,1,1,1,1,1,1,1,1,1,
      1,1,1,1,1,1,1,1,1,1,1,1,1,1,1,1,1,1,1,1,1,1,1,1,1,1,1,1
    ],
    "triggers": [
      {"id": "gv9", "cx": 14, "cy": 7, "r": 1.5, "action": "gravity_flip"},
      {"id": "d10", "cx": 10, "cy": 4, "r": 1.5, "action": "drop_block", "blockCol": 10, "blockRow": 1},
      {"id": "d11", "cx": 18, "cy": 4, "r": 1.5, "action": "drop_block", "blockCol": 18, "blockRow": 1}
    ]
  },
  {
    "pw": 30, "ph": 16, "sx": 1, "sy": 13,
    "map": [
      1,1,1,1,1,1,1,1,1,1,1,1,1,1,1,1,1,1,1,1,1,1,1,1,1,1,1,1,1,1,
      1,0,0,0,0,0,0,0,0,0,0,0,0,0,0,0,0,0,0,0,0,0,0,0,0,0,0,0,0,1,
      1,0,0,0,0,0,0,0,0,0,0,0,0,0,0,0,0,0,0,0,0,0,0,0,0,0,0,0,0,1,
      1,0,0,1,1,1,1,1,1,1,1,1,1,1,1,1,1,1,1,1,1,1,1,1,1,0,0,0,0,1,
      1,0,0,0,0,0,0,0,0,0,0,0,0,0,0,0,0,0,0,0,0,0,0,0,0,0,0,0,0,1,
      1,0,0,0,0,0,0,0,0,0,0,0,0,0,0,0,0,0,0,0,0,0,0,0,0,0,0,0,0,1,
      1,0,0,0,0,0,0,0,0,0,0,0,0,0,0,0,0,0,0,0,0,0,0,0,0,0,0,0,0,1,
      1,0,0,0,0,0,0,0,0,0,0,0,0,0,0,0,0,0,0,0,0,0,0,0,0,0,0,0,0,1,
      1,0,0,0,0,0,0,0,0,0,0,0,0,0,0,0,0,0,0,0,0,0,0,0,0,0,0,0,0,1,
      1,0,0,0,0,0,0,0,0,4,0,0,0,0,0,0,4,0,0,0,0,0,0,0,0,0,0,0,0,1,
      1,0,0,1,1,1,1,1,1,1,1,1,0,0,1,1,1,1,1,1,1,1,0,0,0,0,0,0,0,1,
      1,0,0,0,0,0,0,0,0,0,0,0,0,0,0,0,0,0,0,0,0,0,0,0,0,0,0,0,0,1,
      1,0,0,0,0,0,0,0,0,0,0,0,0,0,0,0,0,0,0,0,0,0,0,0,0,0,0,0,8,1,
      1,1,1,1,1,1,1,1,1,1,1,1,1,1,1,1,1,1,1,1,1,1,1,1,1,1,1,1,1,1,
      1,1,1,1,1,1,1,1,1,1,1,1,1,1,1,1,1,1,1,1,1,1,1,1,1,1,1,1,1,1,
      1,1,1,1,1,1,1,1,1,1,1,1,1,1,1,1,1,1,1,1,1,1,1,1,1,1,1,1,1,1
    ],
    "triggers": [
      {"id": "sp8", "cx": 15, "cy": 12, "r": 1.5, "action": "spike_wall", "row": 12, "cols": [10,11,12,13,14,15,16]},
      {"id": "gv10", "cx": 15, "cy": 7, "r": 1.2, "action": "gravity_flip"},
      {"id": "d12", "cx": 8, "cy": 3, "r": 1.5, "action": "drop_block", "blockCol": 8, "blockRow": 1},
      {"id": "d13", "cx": 22, "cy": 3, "r": 1.5, "action": "drop_block", "blockCol": 22, "blockRow": 1}
    ]
  }
]